00000000
11111111
111C00E1
11111111
11P11111
11111111