111111111111111111111
100000111000001011101
101111011111011011101
101PCE101111011011011
101111101111011010111
101111101111011001111
100000011111011000011
101111101111011011001
101111101011011011101
101111101011011011101
101111101011011011101
100000011100111011101
111111111111111111111