1111111111
1111111111
111C111111
111C0E0011
1111111111