111111111111111111
11P111111111111111
11C111111111111111
11E111111111111111
111111111111111111