111111111111111111111111111
1000000C0000P11E00000C00001
101111111111111111111111101
1011000001110000010111011C1
1C1101111011111011011101101
101101111101111011011011101
101101111101111011010111101
101101111101111011001111101
1011000000111110110000111C1
1C1101111101111011011001101
101101111101011011011101101
101101111101011011011101101
101101111101011011011101101
1011000000111001110111011C1
101111111111111111111111101
10000C00000000000000C000001
111111111111111111111111111